##################################
#o                               #
#                                #
#                                #
#                                #
#                                #
##################               #
#                                #
#                                #
#                                #
#             ####################
#                 #   #          #
#                 # # # #        #
#                 # # # #        #
#                 # # # #        #
#                 # # # #        #
#                 # # # #        #
#                 # # # #        #
#                 # # # #        #
#                 # # # #        #
#       #         # # # #        #
#       #           #   #        #
#       #################        #
#                                #
#                                #
#                                #
#                                #
#                                #
#                                #
#                                #
#                            ### #
#                           #*   #
#                           #    #
##################################