###################################################
*                     #               #           #
################# ### # ### ######### # ##### ### #
#   #             # # # #   #       # #     # #   #
# # # ############# # # # ### ##### ####### # #####
# #   #         #   # # #   # #   #     #   #     #
# ##### # ####### # # # # ### # # ##### # ####### #
# #     # #   #   # # # # #   # #     #       #   #
# ##### ### # # ### # # ### ### ##### ######### # #
#   #   #   # #   #   #   # #       # # #       # #
# # # ### ### ### ####### # ##### # # # # ####### #
# # #       #   #   #   # #     # # # # #   #   # #
# # ####### ### ### # # # ##### # # # # ### # ### #
# # #   #     #       # #     # # # # #   # #   # #
# # # # # ############# # # # # ### # # # # # # # #
# #   # # #         #   # # # # #   #   # # # #   #
####### # # ####### # ##### ### # ######### ### ###
#     # # #       # #       #   #     #   #   #   #
# ### # ######### # ####### # ### ### # # ### ### #
# # # #           #   #     # #     #   #   # # # #
# # # ####### ####### ####### ########### ### # # #
# #         # #     #                   #   # #   #
# ######### # # ### ####### ########### ### # #####
#   #   # # #   #   #     # #       #     # #     #
# # # # # # ##### ### ### ### ##### ##### # ##### #
# # # # #       #   #   #     #   #     #       # #
# # # # ####### ##### # ####### # ##### ######### #
# #   #   #   #     # #   #     #     #         # #
# ####### ### ##### # ### # ####### ########### # #
#       # #       # # #   #     #   #   #     # # #
# ####### # ####### # # ####### # ### # # ### # # #
# #     # # #   #   # #   #     #     #   #   #   #
### ### # # # # # ### ### # ########### ### ##### #
#   #     #   #   #   #   # #         #   #       #
# ########### ####### # ### # ####### # ###########
#     #     # #     # #   # #     # # # #         #
# ### # ### # # ### ##### ####### # # ### ####### #
#   #     # #   #     #   #       # #     #     # #
### ####### ######### # ### ####### ####### ### # #
#   #       #     #   # #   #   #           #   # #
# ### ##### # ### ### # # ##### # ######### # ### #
#   #   #   # # #   #   #     # # #     #   #   # #
### ### # ### # ### ######### # # # ### # ### ### #
# #   # # # #     #         # #   #   # # # # #   #
# ### # # # ##### ##### ### # # ##### # # # # # # #
#   # # #     #   #   #   # # #       # # #   # # #
# # # # ####### ### # ### # # ########### # ### ###
# # # #         #   #   # # #             #   #   #
# # # ############# ### # ################### ### #
# #                 #   #                       #o#
###################################################
