#####################################################################################################
*   #     #       #             #         #                       #   #       #       #   #   #     #
# ### # # # ### ### ####### ### # # ##### ### ########### ### ### # # # # ### ### ### # # # # # # ###
#     # #   #   #   #     #   # # #   # #   # #         # #   #   # # # # # #     # # # # # # # #   #
####### ##### ### ### ### ### # # ### # ### ### ####### ### ### ### # # # # ####### # # # ### # ### #
#       #       #     #   #   # # #   #         #           # # # # #   # #         #   #   # # #   #
# ####### ######### ####### ### ### ### ######### ########### # # # ##### ##### # ######### # # # ###
#     #       #     #       #   #   #   #   #     #   #   #     # #     # #   # #         # #   #   #
# ### ### ##### ##### ####### ### ####### # # ##### # # # # ##### ##### # # # # ##### ##### # ##### #
#   #   # #     #   #   #     #   #   #   # #   #   #   # #     #   #   #   # #     #       # # #   #
### ### # # ##### # ### # ##### # # # # ### ### # ####### ##### # # # ####### ##### ######### # # # #
#   #   # # #   # # #   #     # #   #   #   #   #   #   #   # # # # #   # #   #   # #   #   #   # # #
# ### ##### # # # ### ####### ####### ### ### ##### # # ### # # # ##### # # ### ### # # ### ### # # #
#   #         #   #   #   #   #     #   #   # #     # #     #   #     #   # #         #   #     # # #
### ############# # ### # # ### ### ### ### ### ##### ####### ##### # ### # ############# # ##### # #
#     # #     #   # #   #   #   # #   # #   #   #   #     # #     # # #   #           # # #     # # #
##### # # ### # ### ### ##### ### ### # # ### ### ##### # # ##### ### # ############# # # # ##### # #
#   # # # # # #   #   # #     #   #   # #   #     #   # # #     #   #         #       # # # #   # # #
# # # # # # # ####### # # # ### # # ### ### ##### # # ### # ### ### ####### ### ####### # ### # # ###
# # #   # #         # # # #   # # # #     #       # # #   #   #   #     #   #   #       # #   # #   #
# # ### # ######### # # ### # # ### ##### ######### # # ##### ### ##### ### # ####### # # # ### ### #
# # #   #     #   #   #   # # #   #     #   #   #   #   #   #   #     #   # # #     # #     # #   # #
# # ### ##### # # ####### ### # # ##### ### ### # ####### # ### ### ##### # # # ### ######### ### # #
# #   # #     # # #   #       # #     # #       #       # #       # #   # # #   # #     #   #     # #
# ### ### ##### ### # # ############# # ####### ####### ######### # # # # # ##### ##### # ### ##### #
#   #     #         #   #           # #   #       #     #   #   # #   #   #   #       # #     #     #
### ################### # ######### # ### # ####### # ### # # # ### ######### ### ### # ### ### # # #
#   #           #     # # #       # #   # #   #     # #   #   #   #       #       #   #   #   # # # #
# ### ######### # ### ### ### ### # # ### # ### ####### ######### ####### # ####### ##### ### ### # #
#   # #       #   # #   #   # #   # #     # #   #   #   # #       #   #   #   #   # #   # #       # #
# # # ##### # ##### ### ### # # ### # ####### # # # # ### # ####### # # ##### # # ### # # ######### #
# # #       #       #   #   # #   # #   #   # # # # #     #   #     # # #   # # #     #   #   #   # #
# # ######### ##### # # # ### # ### ### # # # ### # ##### ### ### ##### # # # # ####### ### # # # # #
# #       #   #   # # # # #   # #   #     # #     #   # #   #   #         # # # #   #   #   # # #   #
### ##### # ### # ### # # # ### # ######### ####### # # ### ### ########### ### # # # ### ### ### ###
#   #     # #   #     # # #   # # #   #   #         #   #   # #   #   #   #   #   # # # # # #   #   #
# ######### # ######### # # # ### # # # # ############# # ### ### # # # # ### ##### # # # # ### ### #
#       #   #   #       # # #   #   # # # #         # # #   #   # # #   #   # #     # # #   # # #   #
# ##### # ##### # ##### # ##### ##### # ### ##### # # # ### ### # # ####### # # ##### # ### # # ### #
#     #   #   # # #   # # #     #   # #   # #   # # # # # #   # #   #   #   #   #   # # #   # #   # #
##### ##### # # ### # ### # ### ### # # # # # ### # # # # ### # ##### # # ####### ### # # ### ### # #
# #   #     # #   # #     # #       # # #   #   # #   #     # #   #   #   #   #         # #   # # # #
# # ### # ####### # ####### ######### # ####### # ######### # # ### ####### # ######### # # # # # # #
#   #   #       # # #     #   #     # #   #   # #         # # #   #         #   #   #   #   #   # # #
# ########### # # # # ### # # # ### # ### # # # ####### # # # # # ############# # # ##### ##### # # #
# #     #     # # # #   #   #     # #   # # # # #     # #   # # #     #       #   #       #   # # # #
# ### # # ##### # # # ############# ### # # # # # ### ##### # # # ### ### ########### ##### # # # # #
#     #   #   # #   # #     #     #   # # # #   # # #     # # # #   #   #     #     # #     # # # # #
########### # # ####### ### # ### # ### # # # ### # ##### ### # ### ### ##### # ### ### ##### ### # #
#     #     # #         # # #   #   #   #   # #   #     #     # #   #   #     #   # #   #   #     # #
# ##### # ### ########### # ### ### # ##### ### ##### # ####### # ### ### ####### # # ### # ####### #
# #     # #       #         #   #   # #   # #   #     #     #   # #       #     # #   #   #     #   #
# # ##### ####### # ######### ### ### ### # # ### ######### # ### # ####### # # # ##### ####### # ###
# #     #   #   # # #         # # #   #   # #   # #       # #   # # # #     # # #   #         # #   #
# ##### ### # # ### # ####### # # # ### ### ### # ####### # ### # # # # ##### ##### ### ##### # ### #
#   #   # #   # #   #   #   # #   # # #     # # # #       # #   # #   # #     #   #   #     # # #   #
### # ### ##### # ####### # # # ### # # ##### # # # ### ### # ### ### # # ##### # ### ####### ### ###
#   #     #   # #     #   # # # #   #         #   # #   #   # # # #   # #       #   #   #   #       #
# # ##### # # # ##### # ### # # # ########### ##### ### # ### # # ### # ########### ### # # #########
# #     # # # #     #   # # # # #         # #     #   # # #     #   # #     #   #     #   #   #     #
# ####### # ### ######### # # ########### # ##### ### # # ####### # ####### # # # ### ####### # ### #
#         # #   #         # #         #   # #   #   # # #       # #         # #   # # #   #   # #   #
# ######### # # # ### ##### ##### ##### ### # # ### # ######### # ########### ##### # ### # ### # # #
# #         # # # # #             #   # #     # #   # #       # #   #       #     # #     #     # # #
# ### ### ### ### # ############### # # # ##### # ### # ### ### ### # ##### ### # # ##### ####### # #
#   #   # #   #   #         #   #   # # # #   #   # #   # # #   #   #   # #   # # #     # #   #   # #
### ### # # ### ##### ##### # # # ### # # # # ##### # ### # # ####### # # ### # # ### # # ### # #####
#   #   # #     #     #     # #   # #   # # #   #     #   # # #     # # #   # # #   # # # #   #     #
# ####### ######### ### ##### ##### ##### # ##### ##### ### # # ### ### # ### # ### ### # # ####### #
# #     #           #     #   #     # #   #   #         #   # # # #     # #   #   #   #   #       # #
# ### # ####### ########### ### ### # # ### # # ######### ### # # ####### # ##### ### # ### # ### # #
# #   #       # #     #     #     #   #   # #   #   #     #   # #         # # #   # # # #   # #   # #
# # ######### # # ### # ##### ### ####### ####### # # ### # ### # ####### # # # ### # # ##### ##### #
#   #   #   #   # #     #   #   #       #       # # #   # #     #       # # # #     # # #   #     # #
####### # # ### # ####### ##### ####### # ##### # # # # ######### ##### ### # ##### # # # # ##### # #
#       # #     #   #         #   #   #   #   # # # # #     #   # #   #     #     # # #   #       # #
# # ##### ######### # ####### ### # # ### # # # # # # ### # # # # # # ####### ### # # ########### # #
# #         #       #   #   #     # #   # # # #   # #   # # # # # # #         # #   #     #     # # #
# ####### ### # ######### # ####### ### ### # ##### ### # # # # # # ####### ### ######### # ### # # #
#   #   # #   # #         # #     # # #     # #   #   # # # # # # # #     # #   #   #     # # #   # #
##### # # # ### # ####### # # ### # # ####### # ##### ### # ### # ### ### # # ### # # ##### # ##### #
#     # # # #   #   #   # #     # # #       # #     #     #   # #   #   # #   #   #   #   # #   #   #
# ##### ### ####### # # ####### # # # # ##### # ### ### ##### # ### ### # ### # ######### # ### # ###
# #       #         # #       # #     # #     #   #     #   #   #   #   #   # # #   #   #       #   #
# ####### ##### ##### ####### ######### # ####### ####### # ##### ### ##### ### # # # # # ##### ### #
#     # # #   # #     #             #   # #     # #       #       #   #   #   #   #   # # #   # # # #
##### # # # # # # # ############### ##### # # ### # ############### ### ##### ######### ### # # # # #
#     # #   # # # # #             #   #   # #     #   #         #   #       # #         #   # #   # #
# ##### ##### ### # # ########### ### # ### ######### # ####### # ####### # # # ##### ### ### ##### #
# #     #   #     # # #         # #     # # #       # #   #     # #       # #   #     #   # #   #   #
# # ### # ######### # # ####### # ####### # # ##### # ### # ##### # ######### ######### ### ### # ###
# #   #   #       # # #   #     #       #     #   # #   # #       # #         #         #   #   #   #
# ### ##### # ##### # ### # ########### ####### ### ### # ######### # ######### ##### ##### # ##### #
#   #       #       #   # #           #       #       # #         # #     #   #   #   #   #       # #
### ##### ####### ##### # ######### # ####### # ####### ######### # ##### # # ### ##### # ####### # #
#   #   #   #   #     # # # #   #   # #     # #   #   #     #   # #   #   # #   #       #   #       #
# ### # ##### # ####### # # # # # ### ### ### ##### # ##### # # # ### # ####### ########### #########
# #   #       # #     # #   # # # # #   # #   #   # #       # # # #   # #       #   #     #   #     #
# # ########### # ### # ##### # # # ### # # ### # # ######### # # # ### ### ### # # ##### ### # ### #
#             #     #         #   #       #     #             #   #         #     #         #     #o#
#####################################################################################################
